#########################
#                       #
#                       #
#                       #
#            X          #
#                       #
#                       #
#                       #
#                       #
#########################