#################################################
#     #                             #           #
#     #    ######################## #           #
#     #    #                                    #
#     #    #                        #           #
#     #    #     ########################       #
#     #    #                        #           #
#  #       #               ###      #           #
#  #       #               #        #   #########
#   ####### ################        #           #
#               #                   #           #
#               #   #################           #
#               #                   #######     #
#         ################          #           #
#                #                  #           #
#                #                  #           #
##########       #      ##########  #           #
#                #                ###  ## #######
#                #                  #####       #
#     ########### ################  #           #
#                #                  #######     #
###########      #         #        #      ######
#                #         #        #           #
#                #         #                  X #
#################################################