#########################
#       #       #       #
#       #   X   #       #
#       #       #       #
#       #    ###        #
#    ####               #
#       ###########     #
# ####            #     #
#               #       #
#########################